あまみはるか	天海春香	名詞
きさらぎちはや	如月千早	名詞
はぎわらゆきほ	萩原雪歩	名詞
たかつきやよい	高槻やよい	名詞
あきづきりつこ	秋月律子	名詞
みなせいおり	水瀬伊織	名詞
みうらあずさ	三浦あずさ	名詞
ふたみあみ	双海亜美	名詞
ふたみまみ	双海真美	名詞
きくちまこと	菊地真	名詞
ほしいみき	星井美希	名詞
がなはひびき	我那覇響	名詞
しじょうたかね	四条貴音	名詞
おとなしことり	音無小鳥	名詞
ひだかあい	日高愛	名詞
みずたにえり	水谷絵理	名詞
あきづきりょう	秋月涼	名詞
いしかわみのり	石川実	名詞
おかもとまなみ	岡本まなみ	名詞
おざきれいこ	尾崎玲子	名詞
くろいたかお	黒井崇男	名詞
あまがせとうま	天ヶ瀬冬馬	名詞
いじゅういんほくと	伊集院北斗	名詞
みたらいしょうた	御手洗翔太	名詞
うただおと	歌田音	名詞
かるぐちてつや	軽口哲也	名詞
やまざきすぎお	山崎すぎお	名詞
よしなが	善永	名詞
あくとくまたいち	悪徳又一	名詞
さのみこころ	佐野美心	名詞
やぶしたゆきえ	藪下幸恵	名詞
とうごうじれいか	東豪寺麗華	名詞
あさひなりん	朝比奈りん	名詞
さんじょうともみ	三条ともみ	名詞
たけだそういち	武田蒼一	名詞
そういち	蒼一	名詞
ゆきほ	雪歩	名詞
りつこ	律子	名詞
いおり	伊織	名詞
あみ	亜美	名詞
まみ	真美	名詞
みき	美希	名詞
がなは	我那覇	名詞
たかね	貴音	名詞
おとなし	音無	名詞
とうま	冬馬	名詞
たかお	崇男	名詞
みこころ	美心	名詞
とうごうじ	東豪寺	名詞
